4
_ _ _ t t t t
_ t _ _ _ t t
_ _ t t _ _ t
t _ t t t _ t
_ _ t t t _ t
t t t t t _ t
t _ t _ t _ _