3
_ _ t t t _ _
t _ _ t t t t
_ _ _ _ t t t
_ t t _ _ _ t
_ _ t t _ t t
t _ t _ t t t
t _ _ _ _ _ _