2
_ _ _ _ t _ _
t t t _ t t _
t t t 2 _ _ _
_ _ t _ t t t
_ t t _ _ _ t
_ t _ _ _ 3 _
_ _ _ t t _ _